á: (a:) - an invitation to play
á é é (a e e) - I want to go out
á é u, á á u (a e u, a au) - I want to come in, come in
áu (au) - a protest, an expression of dislike
áe (aæ) - thanks
é (e) - yes
éé (ee) - I want to go out
éá (ea) - greeting, hello
éá á (ea a) - rejection of friendship
éá:r (ea:r)- expression of friendship, flattery
éu (eu) - I don't want to go out
éáu (eau) - I'd like to come in
hmé: (hme:) - threatening with attack
ié (ie)- I want out (strong demand)
iju, iju: (iyu, iyu:) - help, mother
já: (ya:) - yes
má: (ma:) - I love you, love me
máá (maa) - milk
má é (ma e) - let me be
má:r (ma:r) - flattery
máu: (mau:) - call for help, cry out
meé (mæe) - water, thirst
me? (mæ?) - what? (What do you want/have you got/will you do?)
me á é (mæ a e) - lack of water, asking for water
meéeé (mæeæe) - dry cat food
meme (mæmæ) (spoken fast) - sparrow, bird
meö (mæə) - meat, meaty food
mrá: (mra:) - come here
mráá: (mraa:) - protect me
miá (mia) - expression of content, expression of satisfaction
mijáu, mijáo, mijáou (miyau, miyao, miyaou) - expression of hunger, demanding food
mou: (mou:) - offering food, boasting about a killed bird
mre (mræ) - call to attention
mrué (mrue) - follow me
mué (mue) - come
muer (muær) - what's going on with you?
murá (mura) - fish
nyá, nyá: (nya, nya: ) - I'm here, listen to me
nyáé: á (nyae: a) - eat!
nyáu (nyau) - jealousy, expression of discontent
nyáu nyáu nyáu (spoken fast) - don't come near my food
öe (əæ) - what are you doing? How are you?
öráu (ərau) - please come
rá:b (ra:b) - mother cat calls for her kittens
r:eö (r:æə) - kitten calls for its mother
rmá:, r:má: (rma:, r:ma: ) - don't be afraid, everything's OK
rmeö (rmæə) - mouse
rnyáo (rnyao) - dog, danger
rvá (rva) - accusation, blame
uá, uá: (ua, ua:) - stop it, you can't do that, I do not like it
u:m: (u:m:) (with closed mouth) - threatening, less threatening as a growl
váo (vao) - no, I don't want that
é: (e:) - out, outside
u (u): - inside